11111111111
10C0C010001
10000010001
1000001P001
1AE00000001
11111111111
