11111111111
10C0CE10001
10000010001
1000001P001
1A000000001
11111111111
